W1,W1,W1,W1,W1,N ,N ,N ,N ,E1,N ,N ,N ,N ,N ,N ,N ,N ,N ,N
N ,W1,WI,W1,WI,W1,W1,W1,W1,PU,N ,N ,N ,N ,N ,N ,N ,N ,N ,N
N ,N ,N ,W1,W1,W1,WI,W1,W1,PV,W1,N ,N ,N ,N ,N ,N ,N ,N ,N
N ,N ,N ,N ,N ,N ,W1,W1,WI,PV,W1,WI,W1,W1,N ,N ,N ,N ,N ,N
N ,N ,T1,S1,S1,S1,S1,PL,PH,PA,PH,PH,P3,PH,PH,PR,S1,S1,SR,C1
W1,W1,PU,N ,N ,N ,N ,N ,N ,PV,W1,W1,PV,WI,W1,W1,W1,N ,N ,N
WI,W1,PV,WI,N ,N ,N ,N ,N ,PV,N ,W1,PV,W1,W1,W1,W1,N ,N ,N
W1,W1,PV,W1,W1,N ,N ,N ,N ,PD,N ,N ,PV,W1,W1,WI,W1,WI,W1,N
N ,N ,PD,W1,WI,W1,W1,N ,N ,E1,N ,N ,E1,N ,N ,W1,W1,WI,W1,W1
N ,N ,E1,N ,W1,W1,WI,W1,N ,N ,N ,N ,N ,N ,N ,N ,W1,W1,WI,W1